DIRECTION = (left)L
#####E##############
#####|##############
#####|##############
###L-+---L####R-R###
###|#|###|####|#|###
###L-L###|####R-+--S
#########|######|###
#######L-+------R###
#######|#|##########
#######L-L##########
####################
####################