DIRECTION = (right)R
############W#W#W###
S---------------RW##
###W##W#####W###|###
##L------L##W###|W##
##|######|##W###|###
##|#WWWW#R------RW##
##|#WWWW####W#######
##|#WWWW####W#######
WWL----------R######
WWWWWWWW####W|###WWW
WWWWWWW#####WL-----E
############W####WWW