DIRECTION = (down)D
###WW#####S#########
##WWWW####|#####WW##
###WW#####LR####WW##
###########LR###WWW#
#####L---L##L--RWWW#
W####|###RL####LRWW#
#WL--R####R--L#W|WW#
W#|##WWWW####R--R###
#WL--R#WW###########
W####L----R####WW###
WW########|#########
##########E#########